####################
#$***#********#****#
#*##*#*######*#*##*#
#*#**************#*#
#*#*##*##&&##*##*#*#
#P*****#@@@@#******#
#*#*##*######*##*#*#
#*#**************#*#
#*##*#*######*#*##*#
#****#********#***$#
####################