####################
#$***#********#****#
#*##*#*######*#*##*#
#*#***@**********#*#
#*#*##*##&&##*##*#*#
#P*****#@*@@#******#
#*#*##*######*##*#*#
#*#**************#*#
#*##*#*######*#*##*#
#****#********#***$#
####################