################################
#$***#*******************#*****#
#*##*#*#################*#*###*#
#*#**************************#*#
#***#***********************#**#
#*#*##******##B##*******#***#**#
#P#*********#@@@#***#***#**##**#
#***********#####***#***#******#
#******************************#
#******************************#
#*#**************************#*#
#*##*#*#################*#*###*#
#$***#*******************#****$#
################################