################################
#$**#**************************#
#***########*######*########*###
#*#**#*********@@************#*#
#*#**#******###BB###*****#####*#
#*#####*****###@@###*********#*#
#P***#******########*********#*#
#****#***********************#*#
#***############################
#**********####**********####**#
#*#######*#########*############
#****##******##******##********#
#*****************************$#
################################
