####################
#$*********#***#***#
#*******##B##******#
#*#*##**#@@@#***#**#
#P#*##**#####**##**#
#*#######****#*****#
#************#*****#
#*########***#****$#
####################