################################
#$*****************************#
#****##******##******##********#
#**##**************************#
#***********###**###*****####**#
#****##*****#@@*@*@#*****##****#
#P***#******########***********#
#****#*************************#
#****##******************##****#
#**********####**********####**#
#**##**************##**********#
#****##******##******##********#
#*****************************$#
################################
