####################
#$***#********#****#
#*#**#*****##*#*##*#
#*#*##*##*###*##*#*#
#*#**************#*#
#*##*#*######*#*##*#
#*#**************#*#
#*#*##*##&&##*##*#*#
#P*****#@@@@#******#
#*#**#********#***$#
#****#***#****#***$#
#****#***##***#***$#
#****#***##***#***$#
#*##*#*####***#***$#
#****#****#***#***$#
####################